[
    {
        "name": "LEVEL 1",
        "maxDifficulty": "0",
        "map": [
            ["_", "_", "_", "_", "_", "_", "r", "h", "h", "r", "_", "_", "_", "_", "_"],
            ["_", "_", "_", "_", "_", "_", "h", "_", "_", "_", "_", "_", "_", "_", "_"],
            ["_", "_", "_", "r", "h", "h", "r", "_", "_", "_", "_", "_", "_", "_", "_"],
            ["_", "_", "_", "h", "_", "_", "_", "_", "_", "_", "_", "_", "_", "_", "_"],
            ["_", "r", "h", "r", "h", "r", "h", "h", "h", "r", "_", "_", "_", "_", "_"],
            ["_", "_", "_", "h", "_", "_", "_", "_", "_", "_", "_", "_", "_", "_", "_"],
            ["_", "_", "_", "h", "_", "_", "_", "_", "_", "_", "_", "_", "_", "_", "_"],
            ["_", "_", "_", "r", "_", "_", "_", "_", "_", "_", "_", "_", "_", "_", "_"],
            ["_", "_", "_", "h", "_", "_", "_", "_", "_", "_", "_", "_", "_", "_", "_"],
            ["r", "h", "h", "r", "h", "h", "r", "_", "_", "_", "_", "_", "_", "_", "_"],
            ["_", "_", "_", "_", "_", "_", "_", "_", "_", "_", "_", "_", "_", "_", "_"],
            ["_", "_", "_", "_", "_", "_", "_", "_", "_", "_", "_", "_", "_", "_", "_"],
            ["_", "_", "_", "_", "_", "_", "_", "_", "_", "_", "_", "_", "_", "_", "_"],
            ["_", "_", "_", "_", "_", "_", "_", "_", "_", "_", "_", "_", "_", "_", "_"],
            ["_", "_", "_", "_", "_", "_", "_", "_", "_", "_", "_", "_", "_", "_", "_"]
        ],
        "entryCoordinates": [9, 0],
        "exitCoordinates": [0,9]
    },
    {
        "name": "LEVEL 2",
        "maxDifficulty": "1",
        "map": [
                ["_", "_", "_", "_", "_", "_", "_", "_", "_", "r", "_", "r", "_", "_", "_"],
                ["_", "_", "_", "_", "_", "_", "_", "_", "_", "h", "_", "h", "h", "h", "r"],
                ["_", "_", "_", "_", "_", "_", "_", "_", "h", "h", "h", "r", "_", "r", "_"],
                ["_", "_", "_", "_", "_", "_", "_", "_", "h", "_", "_", "h", "_", "h", "_"],
                ["_", "_", "_", "_", "_", "_", "_", "h", "h", "r", "h", "r", "h", "r", "_"],
                ["_", "_", "_", "_", "_", "_", "_", "r", "_", "_", "_", "_", "_", "h", "_"],
                ["_", "_", "_", "_", "_", "_", "_", "h", "_", "_", "_", "_", "h", "h", "r"],
                ["_", "_", "_", "_", "_", "_", "_", "r", "h", "r", "h", "h", "r", "_", "_"],
                ["_", "_", "_", "_", "_", "_", "_", "_", "_", "_", "_", "_", "r", "_", "_"],
                ["_", "_", "_", "_", "_", "_", "_", "_", "_", "_", "_", "_", "h", "_", "_"],
                ["_", "_", "_", "_", "_", "_", "_", "_", "_", "_", "_", "_", "h", "_", "_"],
                ["_", "_", "_", "_", "_", "_", "_", "_", "_", "_", "_", "_", "h", "_", "_"],
                ["_", "_", "_", "_", "_", "_", "_", "_", "_", "_", "_", "_", "r", "_", "_"],
                ["_", "_", "_", "_", "_", "_", "_", "_", "_", "_", "_", "_", "_", "_", "_"],
                ["_", "_", "_", "_", "_", "_", "_", "_", "_", "_", "_", "_", "_", "_", "_"]
        ],
        "entryCoordinates": [0, 9],
        "exitCoordinates": [12,12]
    },
    {
        "name": "LEVEL 3",
        "maxDifficulty": "2",
        "map": [
                ["_", "_", "_", "_", "_", "_", "_", "_", "_", "_", "_", "_", "r", "_", "_"],
                ["_", "_", "_", "_", "_", "_", "_", "_", "r", "_", "r", "_", "h", "_", "_"],
                ["_", "_", "_", "_", "_", "_", "_", "_", "h", "_", "h", "_", "h", "h", "r"],
                ["_", "_", "_", "_", "_", "_", "_", "r", "h", "h", "h", "_", "h", "_", "_"],
                ["_", "_", "_", "_", "_", "_", "_", "h", "_", "_", "r", "_", "r", "_", "_"],
                ["_", "_", "_", "_", "_", "_", "_", "h", "_", "_", "h", "_", "h", "_", "_"],
                ["_", "_", "_", "_", "_", "h", "r", "h", "h", "h", "h", "_", "h", "_", "_"],
                ["_", "_", "_", "_", "_", "h", "_", "_", "_", "_", "h", "_", "r", "_", "_"],
                ["_", "_", "_", "_", "_", "h", "_", "_", "_", "_", "r", "_", "h", "_", "_"],
                ["_", "_", "_", "_", "_", "h", "_", "_", "_", "_", "h", "_", "h", "_", "_"],
                ["_", "_", "r", "h", "h", "h", "r", "h", "r", "h", "h", "h", "r", "_", "_"],
                ["_", "_", "_", "_", "_", "_", "_", "_", "_", "_", "_", "_", "h", "_", "_"],
                ["_", "_", "_", "_", "_", "_", "_", "_", "_", "_", "_", "_", "r", "_", "_"],
                ["_", "_", "_", "_", "_", "_", "_", "_", "_", "_", "_", "_", "_", "_", "_"],
                ["_", "_", "_", "_", "_", "_", "_", "_", "_", "_", "_", "_", "_", "_", "_"]
        ],
        "entryCoordinates": [12, 12],
        "exitCoordinates": [6,6]
    },
    {
        "name": "LEVEL 4",
        "maxDifficulty": "3",
        "map": [
                ["_", "h", "h", "h", "h", "h", "r", "r", "r", "h", "h", "r", "h", "_", "_"],
                ["_", "h", "_", "_", "_", "_", "_", "_", "_", "_", "_", "_", "h", "_", "_"],
                ["_", "r", "_", "_", "_", "_", "_", "_", "_", "_", "_", "_", "r", "_", "_"],
                ["_", "h", "_", "_", "_", "_", "_", "_", "_", "_", "_", "_", "h", "_", "_"],
                ["_", "h", "_", "_", "_", "_", "_", "_", "_", "_", "_", "_", "h", "_", "_"],
                ["_", "h", "_", "_", "_", "_", "_", "_", "_", "_", "_", "_", "r", "_", "_"],
                ["_", "h", "_", "_", "_", "_", "r", "h", "h", "h", "r", "h", "h", "_", "_"],
                ["_", "r", "_", "_", "_", "_", "_", "_", "_", "_", "_", "_", "_", "_", "_"],
                ["_", "r", "_", "_", "_", "_", "_", "_", "_", "_", "_", "_", "_", "_", "_"],
                ["_", "h", "_", "_", "_", "_", "_", "_", "_", "_", "_", "_", "_", "_", "_"],
                ["_", "h", "r", "h", "h", "r", "h", "h", "h", "h", "h", "_", "_", "_", "_"],
                ["_", "_", "_", "_", "_", "_", "_", "_", "_", "_", "r", "_", "_", "_", "_"],
                ["_", "_", "_", "_", "_", "_", "_", "_", "_", "_", "r", "_", "_", "_", "_"],
                ["_", "_", "_", "_", "_", "_", "_", "_", "_", "_", "r", "_", "_", "_", "_"],
                ["r", "h", "h", "h", "h", "h", "h", "r", "h", "h", "h", "_", "_", "_", "_"]
        ],
        "entryCoordinates": [6, 6],
        "exitCoordinates": [12, 2]
    }
]